1 1 1 1 1 1 1 1 1 1 
1 3 3 3 3 5 3 2 3 1 
1 3 3 4 3 3 3 1 5 1 
1 3 3 3 3 3 3 3 3 1 
1 1 1 1 1 3 3 1 2 1 
1 2 3 5 3 3 3 3 3 1 
1 1 1 1 1 1 1 1 1 1 
