1 1 1 1 1 1 1 1 1 1 
1 3 3 3 3 3 3 3 3 1 
1 3 3 2 5 3 3 3 3 1 
1 3 3 5 3 2 3 3 3 1
1 3 3 3 4 3 5 3 3 1
1 3 3 2 3 3 3 3 3 1 
1 1 1 1 1 1 1 1 1 1
