1 1 1 1 1 1 1 1 1 1 
1 3 3 1 3 3 1 3 3 1 
1 3 3 1 3 3 1 3 3 1 
1 2 2 5 3 3 5 4 2 1 
1 3 5 1 3 3 1 3 3 1 
1 3 3 3 3 3 3 3 3 1 
1 1 1 1 1 1 1 1 1 1 
